abbott	123456
abernathy	12345
abshire	123456789
adams	password
altenwerth	iloveyou
anderson	princess
ankunding	1234567
armstrong	rockyou
auer	12345678
aufderhar	abc123
bahringer	nicole
bailey	daniel
balistreri	babygirl
barrows	monkey
bartell	lovely
bartoletti	jessica
barton	654321
bashirian	michael
batz	ashley
bauch	qwerty
baumbach	111111
bayer	iloveu
beahan	000000
beatty	michelle
bechtelar	tigger
becker	sunshine
bednar	chocolate
beer	password1
beier	soccer
berge	anthony
bergnaum	friends
bergstrom	butterfly
bernhard	purple
bernier	angel
bins	jordan
blanda	liverpool
blick	justin
block	loveme
bode	fuckyou
boehm	123123
bogan	football
bogisich	secret
borer	andrea
bosco	carlos
botsford	jennifer
boyer	joshua
boyle	bubbles
bradtke	1234567890
brakus	superman
braun	hannah
breitenberg	amanda
brekke	loveyou
brown	pretty
bruen	basketball
buckridge	andrew
carroll	angels
carter	tweety
cartwright	flower
casper	playboy
cassin	hello
champlin	elizabeth
christiansen	hottie
cole	tinkerbell
collier	charlie
collins	samantha
conn	barbie
connelly	chelsea
conroy	lovers
considine	teamo
corkery	jasmine
cormier	brandon
corwin	666666
cremin	shadow
crist	melissa
crona	eminem
cronin	matthew
crooks	robert
cruickshank	danielle
cummerata	forever
cummings	family
dach	jonathan
damore	987654321
daniel	computer
dare	whatever
daugherty	dragon
davis	vanessa
deckow	cookie
denesik	naruto
dibbert	summer
dickens	sweety
dicki	spongebob
dickinson	joseph
dietrich	junior
donnelly	softball
dooley	taylor
douglas	yellow
doyle	daniela
dubuque	lauren
durgan	mickey
ebert	princesa
effertz	alexandra
eichmann	alexis
emard	jesus
emmerich	estrella
erdman	miguel
ernser	william
fadel	thomas
fahey	beautiful
farrell	mylove
fay	angela
feeney	poohbear
feest	patrick
feil	iloveme
ferry	sakura
fisher	adrian
flatley	alexander
frami	destiny
franecki	christian
friesen	121212
fritsch	sayang
funk	america
gaylord	dancer
gerhold	monica
gerlach	richard
gibson	112233
gislason	princess1
gleason	555555
gleichner	diamond
glover	carolina
goldner	steven
goodwin	rangers
gorczany	louise
gottlieb	orange
goyette	789456
grady	999999
graham	shorty
grant	11111
green	nathan
greenfelder	snoopy
greenholt	gabriel
grimes	hunter
gulgowski	cherry
gusikowski	killer
gutkowski	sandra
gutmann	alejandro
haag	buster
hackett	george
hagenes	brittany
hahn	alejandra
haley	patricia
halvorson	rachel
hamill	tequiero
hammes	7777777
hand	cheese
hane	159753
hansen	arsenal
harber	dolphin
harris	antonio
hartmann	heather
harvey	david
hauck	ginger
hayes	stephanie
heaney	peanut
heathcote	blink182
hegmann	sweetie
heidenreich	222222
heller	beauty
herman	987654
hermann	victoria
hermiston	honey
herzog	00000
hessel	fernando
hettinger	pokemon
hickle	maggie
hilll	corazon
hills	chicken
hilpert	pepper
hintz	cristina
hirthe	rainbow
hodkiewicz	kisses
hoeger	manuel
homenick	myspace
hoppe	rebelde
howe	angel1
howell	ricardo
hudson	babygurl
huel	heaven
huels	55555
hyatt	baseball
jacobi	martin
jacobs	greenday
jacobson	november
jakubowski	alyssa
jaskolski	madison
jast	mother
jenkins	123321
jerde	123abc
jewess	mahalkita
johns	batman
johnson	september
johnston	december
jones	morgan
kassulke	mariposa
kautzer	maria
keebler	gabriela
keeling	iloveyou2
kemmer	bailey
kerluke	jeremy
kertzmann	pamela
kessler	kimberly
kiehn	gemini
kihn	shannon
kilback	pictures
king	asshole
kirlin	sophie
klein	jessie
kling	hellokitty
klocko	claudia
koch	babygirl1
koelpin	angelica
koepp	austin
kohler	mahalko
konopelski	victor
koss	horses
kovacek	tiffany
kozey	mariana
krajcik	eduardo
kreiger	andres
kris	courtney
kshlerin	booboo
kub	kissme
kuhic	harley
kuhlman	ronaldo
kuhn	iloveyou1
kulas	precious
kunde	october
kunze	inuyasha
kuphal	peaches
kutch	veronica
kuvalis	chris
labadie	888888
lakin	adriana
lang	cutie
langosh	james
langworth	banana
larkin	prince
larson	friend
leannon	jesus1
lebsack	crystal
ledner	celtic
leffler	zxcvbnm
legros	edward
lehner	oliver
lemke	diana
lesch	samsung
leuschke	freedom
lind	angelo
lindgren	kenneth
littel	master
little	scooby
lockman	carmen
lowe	456789
lubowitz	sebastian
lueilwitz	rebecca
luettgen	jackie
lynch	spiderman
macejkovic	christopher
maggio	karina
mann	johnny
mante	hotmail
marks	0123456789
marquardt	school
marvin	barcelona
mayer	august
mayert	orlando
mcclure	samuel
mccullough	cameron
mcdermott	slipknot
mcglynn	cutiepie
mckenzie	monkey1
mclaughlin	50cent
medhurst	bonita
mertz	kevin
metz	bitch
miller	maganda
mills	babyboy
mitchell	casper
moen	brenda
mohr	adidas
monahan	kitten
moore	karen
morar	mustang
morissette	isabel
mosciski	natalie
mraz	cuteako
mueller	javier
muller	789456123
murazik	123654
murphy	sarah
murray	bowwow
nader	portugal
nicolas	laura
nienow	777777
nikolaus	marvin
nitzsche	denise
nolan	tigers
oberbrunner	volleyball
okuneva	jasper
olson	rockstar
ondricka	january
oreilly	fuckoff
orn	alicia
ortiz	nicholas
osinski	flowers
pacocha	cristian
padberg	tintin
pagac	bianca
parisian	chrisbrown
parker	chester
paucek	101010
pfannerstill	smokey
pfeffer	silver
pollich	internet
pouros	sweet
powlowski	strawberry
predovic	garfield
price	dennis
prohaska	panget
prosacco	francis
purdy	cassie
quigley	benfica
quitzon	love123
rath	696969
ratke	asdfgh
rau	lollipop
raynor	olivia
reichel	cancer
reichert	camila
reilly	qwertyuiop
reinger	superstar
rempel	harrypotter
renner	ihateyou
reynolds	charles
rice	monique
rippin	midnight
ritchie	vincent
robel	christine
roberts	apples
rodriguez	scorpio
rogahn	jordan23
rohan	lorena
rolfson	andreea
romaguera	mercedes
roob	katherine
rosenbaum	charmed
rowe	abigail
ruecker	rafael
runolfsdottir	icecream
runolfsson	mexico
runte	brianna
russel	nirvana
rutherford	aaliyah
ryan	pookie
sanford	johncena
satterfield	lovelove
sauer	fucker
sawayn	abcdef
schaden	benjamin
schaefer	131313
schamberger	gangsta
schiller	brooke
schimmel	333333
schinner	hiphop
schmeler	aaaaaa
schmidt	mybaby
schmitt	sergio
schneider	welcome
schoen	metallica
schowalter	julian
schroeder	travis
schulist	myspace1
schultz	babyblue
schumm	sabrina
schuppe	michael1
schuster	jeffrey
senger	stephen
shanahan	love
shields	dakota
simonis	catherine
sipes	badboy
skiles	fernanda
smith	westlife
smitham	blondie
spencer	sasuke
spinka	smiley
sporer	jackson
stamm	simple
stanton	melanie
stark	steaua
stehr	dolphins
steuber	roberto
stiedemann	fluffy
stokes	teresa
stoltenberg	piglet
stracke	ronald
streich	slideshow
stroman	asdfghjkl
strosin	minnie
swaniawski	newyork
swift	jason
terry	raymond
thiel	santiago
thompson	jayson
tillman	88888888
torp	5201314
torphy	jerome
towne	gandako
toy	muffin
trantow	gatita
tremblay	babyko
treutel	246810
tromp	sweetheart
turcotte	chivas
turner	ladybug
ullrich	kitty
upton	popcorn
vandervort	alberto
veum	valeria
volkman	cookies
von	leslie
vonrueden	jenny
waelchi	nicole1
walker	12345678910
walsh	leonardo
walter	jayjay
ward	liliana
waters	dexter
watsica	sexygirl
weber	232323
wehner	amores
weimann	rockon
weissnat	christ
welch	babydoll
west	anthony1
white	marcus
wiegand	bitch1
wilderman	fatima
wilkinson	miamor
will	lover
williamson	chris1
willms	single
windler	eeyore
wintheiser	lalala
wisoky	252525
wisozk	scooter
witting	natasha
wiza	skittles
wolf	brooklyn
wolff	colombia
wuckert	159357
wunsch	teddybear
wyman	winnie
yost	happy
yundt	manutd
zboncak	123456a
zemlak	britney
ziemann	katrina
zieme	christina
zulauf	pasaway
